4111111111111111111-
4441444144411111111-
1141414141411111111-
1141414141411111111-
1141414141411111111-
1141414141411111111-
1144414441444444444-
1111111111111111111