4444444444411111111-
4141414141411111111-
1414141414141111111-
4141414141411111111-
1414141414141111111-
4141414141414122221-
1414141414141411111-
1111111111111111111