1111111111111111111-
3333333333333333333-
3333333333333333333-
4141414141411111111-
1414141414141111111-
4444444444444444444-
4444444444444444444-
1111111111111111111